NO ./textures/stone-texture.png
SO ./textures/abstractwall2.png
WE ./textures/abstractwall3.png
EA ./textures/cyberwall1.png


F 29,6,50
C 255,180,92

1111111111111111111111111111111111111111111
1001111111111111111111111111111111111111111
1000000000000001010000000000000101000000011
1101011101110111010111111101110101111101111
1101010001000001000100010001010100000000011
1111011111011101111101010111010111011111011
1101010000000101000001010101000000010000011
1101111111110111011111010101011101011101111
1100000000010100000001000100000101000100011
1111011111110101110111010101011111011101011
1100010100000001000100010101010001010101011
1101110111111101011111111111010111010111011
1101000000000001000001000100000100010001011
1101011111110101011101110101011111111101111
1101000001000101000101010101000100010101011
1101010111111111011111010111010101110101011
1101010000000100010100010001010001000001011
1101010111011101010101111101010111011111011
1101010101000101010100000001010000000000011
1101011101110111110101010111010111111101011
1100000100000100000101010000010000010001011
1101111101010101111111111111010111011111011
1100010001010000010001000000010101010100011
1111110101011101111101110101111101110111011
1101000101000101010001000101010000000100011
1101110101111111011101111101011101110101111
1100010100000101010001000000000100010100011
1101110111011101010101111111011101010111011
1101000101010001000100000101010001010000011
1101010101110111011111011101111111111111111
1100010001000000010101000001010000000100011
1111010101111111110101110101010101111101111
1101010100000001000000010101000100000000011
1101011101110101111101010111011111011111111
1100010001000100010001000001010100010101011
1101011111110111111111011111110111010101011
1101010000010000000100000101010100000000011
1111011101110111011101110101010111011111011
1101000100010001000100010100000000010001011
1101110111011101110101111101010101010111011
1100000001000000010000000001010101000001011
1111111111111111111111111111111111111111N11
1111111111111111111111111111111111111111111
