NO ./textures/cyberwall1.png
SO ./textures/abstractwall.png
WE ./textures/wallb.png
EA ./textures/wallmetalic.png


F 29,6,50
C 255,180,92

11111111111111111111
10000000000000000001
101D1111111111111101
10100000000000000101
10101111111111110101
10101000000000010101
10101011111111010101
10101010000001010101
10101010111101010101
10101010100101010101
10101010100101010101
101010D0100101010101
1010101011D101010101
10101010000001010101
10101011111111010101
10101000000000010101
101011111D1111110101
10100000000000000101
10111111111111111101
100000000000000000N1
11111111111111111111
